20000000000000000001000000000000000000
20000000000000000001000000000000000000
10111110000000000001000000000000000000
10220000111000000001000000000000000000
10333000000000000001000000000000000000
10444111111111111111000000000000000000
10111110000000000001000000000000000000
10220000111000000001000000000000000000
10333000000000000001000000000000000000
11444111111111111111111111111111111111
